================================================================================
||                                                                            ||
||                                                                            ||
||                                                                            ||
||======================================================================      ||
||                                                                            ||
||                                                                            ||
||                                                                            ||
||        ====================================================================||
||                                                                            ||
||                                                                            ||
||                                                                            ||
||====================================================================        ||
||                                                                            ||
||                                                                            ||
||                                                                            ||
||===============================            =================================||
||                                                                            ||
||                                                                            ||
||                                                                            ||
||=================      ========================================      =======||
||                                                                            ||
||                                                                            ||
||                                                                            ||
================================================================================
