================================================================================
||                                                                            ||
||                             LEVEL 2 - HARDER!                              ||
||                                                                            ||
||=============      ================================================      ===||
||                                                                            ||
||                               ==========================                   ||
||                                                                            ||
||=======                                                            =========||
||                                                                            ||
||                                                                            ||
||        ============================================                        ||
||                                                                            ||
||                                                                ============||
||                                                                            ||
||                         ========================                           ||
||                                                                            ||
||==============                                                            ==||
||                                                                            ||
||                                                                            ||
||                                                                            ||
||========================            ===========================             ||
||                                                                            ||
================================================================================
