================================================================================
||                              FINAL LEVEL                                   ||
||                                                                            ||
||        ======      ================      ================      ======      ||
||                                                                            ||
||================            ========                         ===============||
||                                                                            ||
||                       =================================================    ||
||                                                                            ||
||         =======               =================        ====================||
||                                                                            ||
||                                                                            ||
||                                                                            ||
||=============================                         ======================||
||                                                                            ||
||                                                                            ||
||                                                                            ||
||==============================        =======        =======================||
||                                                                            ||
||                                                                            ||
||                                                                            ||
||=======================================================================     ||
||                                                                            ||
================================================================================
